111111111111111111111111111111111111
100000000001111111111111000000000001
111111100000011111111100000000000001
101001000000011111110000000000000001
100000000000001110000000000000000001
100000000000000110000000000000000001
100000000000000110000000000100000001
100000010000000110000000001111000001
100000111000000110000000001111100001
100001110000000111000000011111000001
100011100000000000000000001111000001
100001000000000000000000000011000001
100000000000000000000000000011100001
100000000000000011100000000001000001
100000000000000001100000000000000001
100000000000000000110000000000000001
100000000010000000110000000000000001
100000000111100000110000000000000001
100000000011110000011000000000000001
100000000000100000011000000000000001
100000000000000000011000000000000001
100000000000000000011100000000000001
100000000000000000001100000000000001
110000000000000000001111101000000001
111000000000000000001111111100000001
110000000000000000111111111000000001
100000010000000001111111110000000001
100000111000000001111111111100000001
110000010000100011111111111110000001
111000000001110111111111111100000001
111110000000111111111111111100000001
111111000000111100000011111100000001
111111000000010000000000011000000001
111111100100000000000000000000000001
111111111110000000000000000000000001
111111111111111111111111111111111111









